NNNNNNNNNNNNNNNNNNNNNNNNN
NOONNNNNNNNNNNNONNNNNNNNO
OOOOONNNNNNOOONNNNNNNNNNN
ONONONNNNNNNNNNNNNNNNNNNN
OONNOONNONNNNNNNOONNNNONN
NNNNNNNNNNNNNNNNNNNNNNNNN
NOONNNNNNNNNNNNONNNNNNNNO
OOOOONNNNNNOOONNNNNNNNNNN
ONONONNNNNNNNNNNNNNNNNNNN
OONNOONNONNNNNNNOONNNNONN
NNNNNNNNNNNNNNNNNNNNNNNNN
NOONNNNNNNNNNNNONNNNNNNNO
OOOOONNNNNNOOONNNNNNNNNNN
ONONONNNNNNNNNNNNNNNNNNNN
OONNOONNONNNNNNNOONNNNONN
NNNNNNNNNNNNNNNNNNNNNNNNN
NOONNNNNNNNNNNNONNNNNNNNO
OOOOONNNNNNOOONNNNNNNNNNN
ONONONNNNNNNNNNNNNNNNNNNN
OONNOONNONNNNNNNOONNNNONN
NNNNNNNNNNNNNNNNNNNNNNNNN
NOONNNNNNNNNNNNONNNNNNNNO
OOOOONNNNNNOOONNNNNNNNNNN
ONONONNNNNNNNNNNNNNNNNNNN
OONNOONNONNNNNNNOONNNNONN