ONOONNNNNNNNNNN
ONONNOONOONNNNN
ONNNOOONOOONNNN
NOONONNNNNONOON
NNONNOONOONNONN
ONNNOOONOOONNOO
OOONONNNNNONOOO
OOONNOONOONNOOO
OOONOOONOOONOOO
OOONNNONONNNOOO
OOONOONNNOONOOO
ONNNOOONOOONNNO
NOONNNONONNNOON
NNONOONNNOONONN
OONNOOONOOONNOO
NNNONNONONNOOOO
NNNNONNNNNONNNN